bbbbbbbbbbbbbbbbbbbbbbbbbbbbbbbbbbbbbbbbbbbbbbbbbb
bb..............................................bb
bb..............................................d.
bb...........................k....................
bb...........................pppp........pppp...bb
bb..............................................bb
bb..................................ppp.........bb
bb..................ppp.....pppp................bb
bb..............................................bb
bb............ppp...............................bb
bb..............................................bb
bb......ppp.....................................bb
bb..P.p.........................................bb
bb..................................s...........bb
ffffffffffffffffffffffffffffffffffffffffffffffffff