ffffffffffffffffffffffffffffffffffffffffffffffffff
ff..............................................ff
ff......................C.......................ff
ff..............................................ff
ff..............................................ff
ff..............................................ff
ff..............................................ff
ff..............................................ff
ff..............................................ff
ff..............................................ff
ff..............................................ff
ff..P...........................................ff
ff..............................................ff
ff..............................................ff
ffffffffffffffffffffffffffffffffffffffffffffffffff