ffffffffffffffffffffffffffffffffffffffffffffffffff
ff..............................................ff
ff..............................................ff
ffk.............................................ff
ffpppppp......pp.........pp.........pp..........ff
ff..............................................ff
ff.........................................p....ff
ff..............................................ff
ff.............................................pff
ff...........................C..................ff
ffppppp.....pppp....pppp....pppp....pppp....ppppff
ff..............................................ff
ff..P....p......................................d.
ff................................................
ffffffffffffffffffffffffffffffffffffffffffffffffff